NO ./content/mossy.xpm
SO ./content/mossy.xpm
WE ./content/adventurer_02_01.xpm
EA ./content/adventurer_02_01.xpm






F 0,153,76
C 52,209,226





        1111111111111111111111111
        1000000000110000000000001
        1011000001110000000000001
        1001000000000000000000001
111111111011000001110000000000001
100000000000000001110111111111111
11110111111111011100000010001
111101111   11001010100100001
11000000111111011100000000001
10000000000000001100000010N01
10000000000000001101010010001
1100000111010101111101111000111
11110111 1110101 101111010001
11111111 1111111 111111111111



111111111111111111111111111111
100000000000000000111111111101
100000000000000010000000000011
111111111111111111111111111111