NO ./content/mossy.xpm
SO ./content/mossy.xpm
WE ./content/mossy.xpm
EA ./content/mossy.xpm

F 162,128,105
C 238,247,255

111111
100101
101001
1100N1
111111
