NO ./content/arrow.xpm
SO ./content/arrow.xpm
WE ./content/arrow.xpm
EA ./content/arrow.xpm
F 162,128,105
C 238,247,255
1111111111111111111111111111111111111111111111111
1E00000000100000000000000000000000000000000000001
1011111111101111110111111110111111111111110111101
1000000000000010000000000010000000000000100101111
1011111111001011111011110010011100000111111100001111
100000000100100000000000001001 1111111  1111100000011
10111110110010111111111111110111000001111000010001001
10011000110000000000000000000100100000000000000111011
1101111111101111111111111000010011111111111111001101
1101000000000000000000000000010000000000000000001101
 111111111111111111111011111011111101111111111111101
                     1000000000000001            101
                     1111111111111111            111
