NO ./content/fabric.xpm
SO ./content/fabric.xpm
WE ./content/fabric.xpm
EA ./content/fabric.xpm
F 255,51,51
C 255,255,255

     1111
     1001
     1001
    110011
 111100001111
11000011000011
11000011000011
 111100001111
    110011
     1001
     10N1
     1111
