NO ./content/dragon.xpm
SO ./content/dragon.xpm
WE ./content/dragon.xpm
EA ./content/dragon.xpm

F 117,54,222
C 52,209,226

                 11111111111111111111111111111111
                 10000000000000000000000000000001
                 10111111111111000000000000000001
                 10100000000001000000000000000001
                 10101111111101000000000000000001
                 10101000000101000111101010001001
                 10101011110101000100001011001001
                 1010101E010101000111001010101001      111
                 10101000010101000100001010011001      101
                 10101111110101000100001010001001      111
                 10100000000101000000000000000001
                 10111111111101000000000000000001
                 10000000000001000000000000000001
                 11111111111111111111111111111111
